1 1 1 1 1 1 1 1 1 1 1 1 1 1 1
1 0 0 0 0 1 0 0 0 1 0 0 0 m 1
1 0 1 1 0 1 0 1 0 1 0 p 0 0 1
1 0 0 0 0 0 0 1 0 0 0 0 0 0 1
1 1 1 0 1 1 0 1 1 1 1 1 1 0 1
1 l 0 0 0 0 0 1 n 0 0 0 1 0 1
1 0 o 0 0 1 1 1 0 0 1 0 1 3 1
1 0 0 0 0 0 0 0 0 0 0 0 0 0 1
1 1 1 1 1 1 1 1 1 1 1 1 1 1 1