1 1 1 1 1 1 1 1 1 1 1 1 1 1 1 1
1 0 0 1 2 0 1 1 0 0 3 o 1 1 1 1
1 n 0 0 0 0 0 0 0 1 0 0 0 1 1 1
1 0 0 0 1 1 0 0 0 1 0 1 1 1 2 1
1 1 o 0 0 1 0 1 0 0 0 0 0 0 0 1
1 1 0 0 1 1 0 1 1 0 0 1 0 0 0 1
1 0 0 0 0 0 2 0 1 0 0 0 v 1 0 1
1 1 0 1 1 1 1 1 0 0 2 1 1 1 0 1
1 c 3 0 0 0 0 0 0 0 0 0 2 0 p 1
1 1 1 1 1 1 1 1 1 1 1 1 1 1 1 1