1 1 1 1 1 1 1 1 1 1 1 1 1 1 1 1 1
1 0 o 0 3 0 0 0 0 2 0 1 0 0 4 0 1
1 x 0 1 1 0 2 0 0 0 0 0 0 2 0 1 1
1 0 0 0 1 2 0 0 0 0 0 0 0 0 2 1 1
1 1 0 0 0 0 1 1 1 0 0 1 1 0 0 p 1
1 1 0 0 1 0 1 1 v 2 0 1 1 0 0 0 1
1 1 0 1 1 0 0 0 0 0 0 0 2 0 1 1 1
1 0 0 0 0 1 0 0 p 4 0 2 0 0 1 1 1
1 2 0 0 0 3 0 1 1 0 1 1 1 0 0 2 1
1 z 1 1 1 0 0 1 0 0 0 0 0 5 0 o 1
1 1 1 1 1 1 1 1 1 1 1 1 1 1 1 1 1