1 1 1 1 1 1 1 1 1 1 1 1 1 1 1
1 0 0 0 0 1 0 0 0 1 0 0 0 0 1
1 0 1 1 0 1 0 1 0 1 0 0 0 0 1
1 0 0 0 0 3 0 1 0 0 0 0 0 0 1
1 1 1 0 1 1 0 1 1 1 1 1 1 0 1
1 l 0 0 0 0 0 1 n 0 0 0 1 0 1
1 0 o 0 0 1 1 1 0 0 1 0 1 2 1
1 0 0 0 0 0 0 0 0 0 0 0 0 0 1
1 1 1 1 1 1 1 1 1 1 1 1 1 1 1