1 1 1 1 1 1 1 1 1 1 1 1 1 1 1 1 1
1 0 o 0 0 0 0 0 0 2 0 1 0 0 0 0 1
1 x 0 1 1 0 0 0 0 0 0 0 0 0 0 1 1
1 0 0 0 1 0 0 0 0 0 0 0 0 0 0 1 1
1 1 0 0 0 0 1 1 1 0 0 1 1 0 0 p 1
1 1 0 0 1 0 1 1 v 0 0 1 1 0 0 0 1
1 1 0 1 1 0 0 0 0 0 0 0 0 0 1 1 1
1 0 0 0 0 1 0 0 p 0 0 0 0 0 1 1 1
1 0 0 0 0 0 0 1 1 0 1 1 1 0 0 0 1
1 z 1 1 1 0 0 1 0 0 0 0 0 0 0 o 1
1 1 1 1 1 1 1 1 1 1 1 1 1 1 1 1 1